8 8
########
#   #  #
# # #$@#
#    $@#
# # #$@#
#   #* #
#####  #
    ####