10 9
######    
  #  #####
### @#   #
#*  $    #
# ##%#####
#   $  #  
### @  #  
  #  ###  
  ####    