7 7
#######
#   @ #
# # # #
# $*$ #
# # #@#
#  %  #
#######